el	ελληνικά
en	english
vi	việt
ca	català
it	italiano
cz	česky
ar	العربية
id	Indonesia
es	español
ru	русский
nl	nederlands
pt	português
zh-tw	中國（繁體）
tr	Türk
lv	latviešu valoda
zh-cn	中国（简体）
th	ไทย
ro	român
pl	polski
ta	தமிழ்
fr	français
hr	hrvatski
de	deutsch
hu	magyar
hi	हिंदी
pt-BR	português brasileiro
bs	bosanski
ja	日本語
he	עברית
sr	српски
ko	한국의
kn	ಕನ್ನಡ
sk	slovenčina